Date,Recovered,Cumulative Recovered,Imported Case,Local Case,Active Case,New Case,Cumulative Case,ICU,Ventilator,Death,Cumulative Death,SMA_new,EMA_0.1,EMA_0.3,SMA_death
2020-03-27,44,259,,,1876,130,2161,54,34,3,26,130.0,130.0,130.0,3.0
2020-03-28,61,320,,,1973,159,2320,73,54,1,27,144.5,145.26,147.06,2.0
2020-03-29,68,388,,,2048,150,2470,73,52,7,34,146.33,147.01,148.4,3.67
2020-03-30,91,479,,,2110,156,2626,94,62,3,37,148.75,149.62,151.4,3.5
2020-03-31,58,537,,,2186,140,2766,94,60,6,43,147.0,147.27,147.29,4.0
2020-04-01,108,645,,,2218,142,2908,102,66,2,45,146.17,146.15,145.49,3.67
2020-04-02,122,767,,,2299,208,3116,105,54,5,50,155.0,158.0,165.93,3.86
2020-04-03,60,827,,,2453,217,3333,108,54,3,53,167.43,168.36,182.19,3.86
2020-04-04,88,915,,,2511,150,3483,99,50,4,57,166.14,165.37,172.12,4.29
2020-04-05,90,1005,,,2596,179,3662,99,48,4,61,170.29,167.46,174.25,3.86
2020-04-06,236,1241,,,2490,131,3793,102,54,1,62,166.71,162.15,161.01,3.57
2020-04-07,80,1321,,,2579,170,3963,92,50,1,63,171.0,163.24,163.75,2.86
2020-04-08,166,1487,,,2567,156,4119,76,45,2,65,173.0,162.27,161.4,2.86
2020-04-09,121,1608,,,2553,109,4228,72,43,2,67,158.86,155.36,145.57,2.43
2020-04-10,222,1830,,,2446,118,4346,69,40,3,70,144.71,150.66,137.26,2.43
2020-04-11,165,1995,,,2462,184,4530,72,38,3,73,149.57,154.75,151.33,2.29
2020-04-12,113,2108,,,2499,153,4683,66,37,3,76,145.86,154.54,151.83,2.14
2020-04-13,168,2276,,,2464,134,4817,66,36,1,77,146.29,152.12,146.47,2.14
2020-04-14,202,2478,,,2427,170,4987,60,33,5,82,146.29,154.19,153.54,2.71
2020-04-15,169,2647,,,2342,85,5072,56,32,1,83,136.14,146.31,132.96,2.57
2020-04-16,119,2766,,,2332,110,5182,56,29,1,84,136.29,142.24,126.07,2.43
2020-04-17,201,2967,,,2198,69,5251,51,26,2,86,129.29,134.11,108.94,2.29
2020-04-18,135,3102,,,2115,54,5305,49,26,2,88,110.71,125.32,92.45,2.14
2020-04-19,95,3197,,,2103,84,5389,46,26,1,89,100.86,120.83,89.92,1.86
2020-04-20,98,3295,,,2041,36,5425,45,28,0,89,86.86,111.69,73.74,1.71
2020-04-21,54,3349,,,2041,57,5482,43,27,3,92,70.71,105.85,68.72,1.43
2020-04-22,103,3452,,,1987,50,5532,43,25,1,93,65.71,99.92,63.1,1.43
2020-04-23,90,3542,,,1966,71,5603,42,21,2,95,60.14,96.86,65.47,1.57
2020-04-24,121,3663,,,1932,88,5691,41,18,1,96,62.86,95.93,72.23,1.43
2020-04-25,99,3762,,,1882,51,5742,36,16,2,98,62.43,91.24,65.86,1.43
2020-04-26,100,3862,,,1820,38,5780,36,15,0,98,55.86,85.71,57.5,1.29
2020-04-27,95,3957,,,1764,40,5820,37,17,1,99,56.43,80.97,52.25,1.43
2020-04-28,75,4032,,,1719,31,5851,36,17,1,100,52.71,75.82,45.88,1.14
2020-04-29,55,4087,,,1758,94,5945,40,18,0,100,59.0,77.69,60.31,1.0
2020-04-30,84,4171,,,1729,57,6002,36,14,2,102,57.0,75.57,59.32,1.0
2020-05-01,39,4210,,,1758,69,6071,37,14,1,103,54.29,74.89,62.22,1.0
2020-05-02,116,4326,,,1747,105,6176,31,12,0,103,62.0,77.97,75.06,0.71
2020-05-03,87,4413,,,1780,122,6298,27,13,2,105,74.0,82.45,89.14,1.0
2020-05-04,71,4484,,,1764,55,6353,28,13,0,105,76.14,79.66,78.9,0.86
2020-05-05,83,4567,,,1710,30,6383,24,8,1,106,76.0,74.62,64.23,0.86
2020-05-06,135,4702,,,1619,45,6428,22,9,1,107,69.0,71.62,58.46,1.0
2020-05-07,74,4776,,,1584,39,6467,19,8,0,107,66.43,68.32,52.62,0.71
2020-05-08,88,4864,,,1564,68,6535,18,7,0,107,66.29,68.28,57.24,0.57
2020-05-09,65,4929,,,1552,54,6589,18,6,1,108,59.0,66.84,56.26,0.71
2020-05-10,96,5025,,,1523,67,6656,18,6,0,108,51.14,66.86,59.49,0.43
2020-05-11,88,5113,,,1504,70,6726,20,7,1,109,53.29,67.17,62.64,0.57
2020-05-12,110,5223,,,1410,16,6742,16,3,0,109,51.29,62.02,48.65,0.43
2020-05-13,58,5281,,,1387,37,6779,16,4,2,111,50.14,59.5,45.15,0.57
2020-05-14,70,5351,,,1356,40,6819,16,4,1,112,50.29,57.54,43.61,0.71
2020-05-15,88,5439,,,1304,36,6855,14,5,0,112,45.71,55.38,41.33,0.71
2020-05-16,73,5512,,,1247,17,6872,13,5,1,113,40.43,51.52,34.03,0.71
2020-05-17,59,5571,,,1210,22,6894,13,7,0,113,34.0,48.56,30.42,0.71
2020-05-18,44,5615,,,1213,47,6941,13,6,0,113,30.71,48.4,35.39,0.57
2020-05-19,31,5646,,,1218,37,6978,11,6,1,114,33.71,47.26,35.88,0.71
2020-05-20,60,5706,,,1189,31,7009,11,7,0,114,32.86,45.63,34.41,0.43
2020-05-21,90,5796,,,1149,50,7059,10,7,0,114,34.29,46.06,39.09,0.29
2020-05-22,63,5859,,,1163,78,7137,9,5,1,115,40.29,49.27,50.76,0.43
2020-05-23,53,5912,,,1158,48,7185,9,5,0,115,44.71,49.14,49.93,0.29
2020-05-24,33,5945,,,1185,60,7245,9,4,0,115,50.14,50.23,52.95,0.29
2020-05-25,34,5979,,,1323,172,7417,8,4,0,115,68.0,62.43,88.67,0.29
2020-05-26,62,6041,,,1448,187,7604,8,5,0,115,89.43,74.9,118.17,0.14
2020-05-27,42,6083,,,1421,15,7619,8,4,0,115,87.14,68.9,87.22,0.14
2020-05-28,86,6169,,,1345,10,7629,8,4,0,115,81.43,63.01,64.05,0.14
2020-05-29,66,6235,,,1382,103,7732,8,2,0,115,85.0,67.01,75.74,0.0
2020-05-30,95,6330,,,1317,30,7762,9,2,0,115,82.43,63.31,62.02,0.0
2020-05-31,23,6353,,,1351,57,7819,9,2,0,115,82.0,62.67,60.51,0.0
2020-06-01,51,6404,,,1338,38,7857,8,2,0,115,62.86,60.2,53.76,0.0
2020-06-02,66,6470,,,1292,20,7877,6,2,0,115,39.0,56.18,43.63,0.0
2020-06-03,61,6531,,,1324,93,7970,6,2,0,115,50.14,59.87,58.44,0.0
2020-06-04,28,6559,,,1573,277,8247,6,2,0,115,88.29,81.59,124.01,0.0
2020-06-05,51,6610,,,1540,19,8266,6,1,1,116,76.29,75.33,92.51,0.14
2020-06-06,25,6635,,,1551,37,8303,5,5,1,117,77.29,71.5,75.85,0.29
2020-06-07,39,6674,,,1531,19,8322,5,5,0,117,71.86,66.24,58.8,0.29
2020-06-08,20,6694,,,1518,7,8329,6,1,0,117,67.43,60.32,43.26,0.29
2020-06-09,281,6975,,,1244,7,8336,6,1,0,117,65.57,54.98,32.38,0.29
2020-06-10,39,7014,,,1206,2,8338,5,5,1,118,52.57,49.68,23.27,0.43
2020-06-11,51,7065,,,1186,31,8369,5,5,0,118,17.43,47.81,25.59,0.43
2020-06-12,103,7168,,,1115,33,8402,4,4,1,119,19.43,46.33,27.81,0.43
2020-06-13,143,7311,,,1014,43,8445,4,4,1,120,20.29,46.0,32.37,0.43
2020-06-14,35,7346,,,986,8,8453,4,4,1,121,18.71,42.2,25.06,0.57
2020-06-15,54,7400,,,973,41,8494,4,4,0,121,23.57,42.08,29.84,0.57
2020-06-16,333,7733,,,651,11,8505,4,4,0,121,24.14,38.97,24.19,0.57
2020-06-17,140,7873,,,521,10,8515,4,4,0,121,25.29,36.07,19.93,0.43
2020-06-18,127,8000,,,408,14,8529,4,4,0,121,22.86,33.86,18.15,0.43
2020-06-19,70,8070,,,344,6,8535,3,3,0,121,19.0,31.08,14.51,0.29
2020-06-20,76,8146,,,289,21,8556,3,3,0,121,15.86,30.07,16.45,0.14
2020-06-21,10,8156,,,295,16,8572,3,3,0,121,17.0,28.66,16.32,0.0
2020-06-22,21,8177,,,289,15,8587,2,2,0,121,13.29,27.3,15.92,0.0
2020-06-23,9,8186,,,283,3,8590,3,3,0,121,12.14,24.87,12.05,0.0
2020-06-24,45,8231,,,244,6,8596,2,2,0,121,11.57,22.98,10.23,0.0
2020-06-25,40,8271,,,208,4,8600,2,2,0,121,10.14,21.08,8.36,0.0
2020-06-26,23,8294,,,191,6,8606,2,2,0,121,10.14,19.57,7.65,0.0
2020-06-27,14,8308,,,187,10,8616,2,2,0,121,8.57,18.62,8.36,0.0
2020-06-28,10,8318,,,195,18,8634,2,2,0,121,8.86,18.55,11.25,0.0
2020-06-29,16,8334,,,182,3,8637,4,1,0,121,7.14,17.0,8.78,0.0
2020-06-30,20,8354,,,164,2,8639,4,1,0,121,7.0,15.5,6.74,0.0
2020-07-01,21,8375,,,144,1,8640,4,2,0,121,6.29,14.05,5.02,0.0
2020-07-02,62,8437,,,85,3,8643,2,0,0,121,6.14,12.94,4.41,0.0
2020-07-03,9,8446,,,81,5,8648,2,0,0,121,6.0,12.15,4.59,0.0
2020-07-04,15,8461,,,76,10,8658,2,0,0,121,6.0,11.93,6.21,0.0
2020-07-05,4,8465,,,77,5,8663,2,0,0,121,4.14,11.24,5.85,0.0
2020-07-06,11,8476,,,71,5,8668,2,0,0,121,4.43,10.62,5.59,0.0
2020-07-07,5,8481,,,72,6,8674,2,0,0,121,5.0,10.16,5.72,0.0
2020-07-08,5,8486,,,70,3,8677,2,1,0,121,5.29,9.44,4.9,0.0
2020-07-09,13,8499,,,63,6,8683,2,1,0,121,5.71,9.1,5.23,0.0
2020-07-10,12,8511,,,64,13,8696,2,2,0,121,6.86,9.49,7.56,0.0
2020-07-11,4,8515,,,67,8,8704,3,2,1,122,6.57,9.34,7.69,0.14
2020-07-12,4,8519,,,77,14,8718,3,2,0,122,7.86,9.8,9.59,0.14
2020-07-13,1,8520,,,83,7,8725,4,3,0,122,8.14,9.52,8.81,0.14
2020-07-14,4,8524,,,83,4,8729,6,2,0,122,7.86,8.97,7.37,0.14
2020-07-15,2,8526,,,86,5,8734,5,1,0,122,8.14,8.57,6.66,0.14
2020-07-16,12,8538,,,77,3,8737,3,1,0,122,7.71,8.02,5.56,0.14
2020-07-17,3,8541,,,92,18,8755,3,3,0,122,8.43,9.01,9.29,0.14
2020-07-18,5,8546,,,96,9,8764,1,1,0,122,8.57,9.01,9.2,0.0
2020-07-19,7,8553,,,103,15,8779,2,1,1,123,8.71,9.61,10.94,0.14
2020-07-20,2,8555,,,122,21,8800,3,1,0,123,10.71,10.75,13.96,0.14
2020-07-21,7,8562,,,130,15,8815,4,1,0,123,12.29,11.18,14.27,0.14
2020-07-22,4,8566,,,142,16,8831,5,1,0,123,13.86,11.66,14.79,0.14
2020-07-23,8,8574,,,143,9,8840,5,2,0,123,14.71,11.39,13.05,0.14
2020-07-24,3,8577,,,161,21,8861,5,2,0,123,15.14,12.35,15.44,0.14
2020-07-25,17,8594,,,167,23,8884,3,2,0,123,17.14,13.42,17.71,0.14
2020-07-26,6,8600,,,173,13,8897,2,1,1,124,16.86,13.38,16.29,0.14
2020-07-27,1,8601,,,179,7,8904,0,0,0,124,14.86,12.74,13.51,0.14
2020-07-28,6,8607,,,212,39,8943,1,1,0,124,18.29,15.36,21.15,0.14
2020-07-29,5,8612,,,220,13,8956,2,1,0,124,17.86,15.13,18.71,0.14
2020-07-30,5,8617,,,223,8,8964,3,1,0,124,17.71,14.42,15.5,0.14
2020-07-31,27,8644,,,207,12,8976,3,1,1,125,16.43,14.17,14.45,0.29
2020-08-01,3,8647,,,213,9,8985,2,1,0,125,14.43,13.66,12.81,0.29
2020-08-02,17,8664,,,210,14,8999,2,1,0,125,14.57,13.69,13.17,0.14
2020-08-03,4,8668,,,208,2,9001,1,1,0,125,13.86,12.52,9.82,0.14
2020-08-04,16,8684,,,193,1,9002,0,0,0,125,8.43,11.37,7.17,0.14
2020-08-05,18,8702,,,196,21,9023,2,2,0,125,9.57,12.33,11.32,0.14
2020-08-06,11,8713,,,200,15,9038,2,1,0,125,10.57,12.6,12.42,0.14
2020-08-07,15,8728,,,210,25,9063,2,1,0,125,12.43,13.84,16.2,0.0
2020-08-08,47,8775,,,170,7,9070,2,1,0,125,12.14,13.16,13.44,0.0
2020-08-09,9,8784,,,174,13,9083,1,1,0,125,12.0,13.14,13.31,0.0
2020-08-10,19,8803,,,166,11,9094,1,1,0,125,13.29,12.93,12.61,0.0
2020-08-11,6,8809,,,169,9,9103,2,2,0,125,14.43,12.53,11.53,0.0
2020-08-12,8,8817,,,172,11,9114,1,1,0,125,13.0,12.38,11.37,0.0
2020-08-13,4,8821,,,183,15,9129,2,2,0,125,13.0,12.64,12.46,0.0
2020-08-14,7,8828,,,196,20,9149,4,1,0,125,12.29,13.38,14.72,0.0
2020-08-15,3,8831,,,219,26,9175,6,1,0,125,15.0,14.64,18.11,0.0
2020-08-16,28,8859,,,216,25,9200,7,2,0,125,16.71,15.68,20.17,0.0
2020-08-17,17,8876,,,211,12,9212,8,2,0,125,16.86,15.31,17.72,0.0
2020-08-18,26,8902,,,192,7,9219,8,2,0,125,16.57,14.48,14.51,0.0
2020-08-19,23,8925,,,185,16,9235,7,3,0,125,17.29,14.63,14.95,0.0
2020-08-20,7,8932,,,183,5,9240,7,4,0,125,15.86,13.67,11.97,0.0
2020-08-21,13,8945,,,179,9,9249,7,4,0,125,14.29,13.2,11.08,0.0
2020-08-22,4,8949,,,183,8,9257,8,4,0,125,11.71,12.68,10.15,0.0
2020-08-23,10,8959,,,183,10,9267,9,4,0,125,9.57,12.41,10.11,0.0
2020-08-24,6,8965,,,184,7,9274,8,5,0,125,8.86,11.87,9.18,0.0
2020-08-25,6,8971,,,189,11,9285,8,6,0,125,9.43,11.78,9.72,0.0
2020-08-26,7,8978,,,188,6,9291,9,6,0,125,8.0,11.21,8.61,0.0
2020-08-27,16,8994,,,177,5,9296,8,6,0,125,8.0,10.58,7.52,0.0
2020-08-28,36,9030,,,151,10,9306,8,6,0,125,8.14,10.53,8.27,0.0
2020-08-29,8,9038,,,154,11,9317,8,6,0,125,8.57,10.57,9.09,0.0
2020-08-30,10,9048,,,160,17,9334,7,5,1,126,9.57,11.22,11.46,0.14
2020-08-31,6,9054,,,159,6,9340,6,4,1,127,9.43,10.69,9.82,0.29
2020-09-01,21,9075,,,151,14,9354,5,3,1,128,9.86,11.03,11.08,0.43
2020-09-02,4,9079,,,153,6,9360,4,3,0,128,9.86,10.52,9.55,0.43
2020-09-03,4,9083,,,163,14,9374,4,3,0,128,11.14,10.87,10.89,0.43
2020-09-04,9,9092,,,165,11,9385,4,3,0,128,11.29,10.88,10.92,0.43
2020-09-05,21,9113,,,150,6,9391,5,3,0,128,10.57,10.4,9.44,0.43
2020-09-06,2,9115,,,154,6,9397,6,3,0,128,9.0,9.96,8.41,0.29
2020-09-07,9,9124,,,207,62,9459,6,4,0,128,17.0,15.16,24.49,0.14
2020-09-08,12,9136,,,295,100,9559,7,4,0,128,29.29,23.64,47.14,0.0
2020-09-09,7,9143,,,312,24,9583,7,4,0,128,31.86,23.68,40.2,0.0
2020-09-10,24,9167,,,333,45,9628,9,5,0,128,36.29,25.81,41.64,0.0
2020-09-11,14,9181,,,501,182,9810,9,5,0,128,60.71,41.43,83.75,0.0
2020-09-12,8,9189,,,551,58,9868,9,5,0,128,68.14,43.09,76.02,0.0
2020-09-13,7,9196,,,591,47,9915,9,4,0,128,74.0,43.48,67.32,0.0
2020-09-14,7,9203,,,615,31,9946,11,5,0,128,69.57,42.23,56.42,0.0
2020-09-15,6,9209,,,632,23,9969,14,4,0,128,58.57,40.31,46.39,0.0
2020-09-16,26,9235,,,668,62,10031,15,3,0,128,64.0,42.48,51.08,0.0
2020-09-17,15,9250,,,674,21,10052,13,2,0,128,60.57,40.33,42.05,0.0
2020-09-18,14,9264,,,754,95,10147,11,2,1,129,48.14,45.8,57.94,0.14
2020-09-19,51,9315,,,722,20,10167,12,2,1,130,42.71,43.22,46.56,0.29
2020-09-20,40,9355,,,734,52,10219,10,2,0,130,43.43,44.1,48.19,0.29
2020-09-21,40,9395,,,751,57,10276,9,2,0,130,47.14,45.39,50.83,0.29
2020-09-22,168,9563,,,665,82,10358,9,2,0,130,55.57,49.05,60.18,0.29
2020-09-23,39,9602,,,770,147,10505,8,2,3,133,67.71,58.84,86.23,0.71
2020-09-24,64,9666,,,777,71,10576,6,2,0,133,74.86,60.06,81.66,0.71
2020-09-25,30,9696,,,858,111,10687,4,3,0,133,77.14,65.15,90.46,0.57
2020-09-26,89,9785,,,851,82,10769,8,4,0,133,86.0,66.84,87.92,0.43
2020-09-27,50,9835,,,950,150,10919,6,4,1,134,100.0,75.15,106.55,0.57
2020-09-28,54,9889,,,1011,115,11034,8,5,0,134,108.29,79.14,109.08,0.57
2020-09-29,50,9939,,,1062,101,11135,13,5,0,134,111.0,81.32,106.66,0.57
2020-09-30,28,9967,,,1121,89,11224,16,3,2,136,102.71,82.09,101.36,0.43
2020-10-01,47,10014,,,1334,260,11484,20,3,0,136,129.71,99.88,148.95,0.43
2020-10-02,81,10095,,,1540,287,11771,22,4,0,136,154.86,118.59,190.37,0.43
2020-10-03,121,10216,,,1735,317,12088,29,4,1,137,188.43,138.43,228.36,0.57
2020-10-04,67,10283,,,1961,293,12381,28,4,0,137,208.86,153.89,247.75,0.43
2020-10-05,57,10340,,,2336,432,12813,32,8,0,137,254.14,181.7,303.02,0.43
2020-10-06,87,10427,,,2936,691,13504,31,8,4,141,338.43,232.63,419.42,1.0
2020-10-07,74,10501,,,3351,489,13993,40,13,0,141,395.57,258.27,440.29,0.71
2020-10-08,18,10519,,,3703,375,14368,60,20,5,146,412.0,269.94,420.7,1.43
2020-10-09,188,10707,,,3863,354,14722,68,25,6,152,421.57,278.35,400.69,2.29
2020-10-10,73,10780,,,4161,374,15096,73,28,3,155,429.71,287.91,392.69,2.57
2020-10-11,133,10913,,,4587,561,15657,90,29,2,157,468.0,315.22,443.18,2.86
2020-10-12,109,11022,,,5039,563,16220,98,29,2,159,486.71,340.0,479.13,3.14
2020-10-13,350,11372,,,5345,660,16880,101,32,4,163,482.29,372.0,533.39,3.14
2020-10-14,233,11605,,,5768,660,17540,108,35,4,167,506.71,400.8,571.37,3.71
2020-10-15,409,12014,,,5945,589,18129,103,31,3,170,537.29,419.62,576.66,3.43
2020-10-16,245,12259,,,6323,629,18758,99,31,6,176,576.57,440.56,592.36,3.43
2020-10-17,302,12561,,,6886,869,19627,91,30,4,180,647.29,483.4,675.35,3.57
2020-10-18,701,13262,,,7049,871,20498,86,28,7,187,691.57,522.16,734.05,4.29
2020-10-19,455,13717,,,7456,865,21363,99,32,3,190,734.71,556.45,773.33,4.43
2020-10-20,634,14351,,,7681,862,22225,95,29,3,193,763.57,587.0,799.93,4.29
2020-10-21,580,14931,,,7827,732,22957,102,31,6,199,773.86,601.5,779.55,4.57
2020-10-22,486,15417,,,8183,847,23804,90,29,5,204,810.71,626.05,799.79,4.86
2020-10-23,467,15884,,,8416,710,24514,90,28,10,214,822.29,634.45,772.85,5.43
2020-10-24,671,16555,,,8966,1228,25742,92,31,7,221,873.57,693.8,909.4,5.86
2020-10-25,579,17134,,,9202,823,26565,99,30,8,229,866.71,706.72,883.48,6.0
2020-10-26,691,17825,,,9744,1240,27805,94,31,7,236,920.29,760.05,990.43,6.57
2020-10-27,674,18499,,,9903,835,28640,89,32,2,238,916.43,767.54,943.8,6.43
2020-10-28,573,19072,,,10123,801,29441,94,25,8,246,926.29,770.89,900.96,6.71
2020-10-29,685,19757,,,10087,649,30090,106,23,0,246,898.0,758.7,825.37,6.0
2020-10-30,491,20248,,,10392,799,30889,90,20,3,249,910.71,762.73,817.46,5.0
2020-10-31,1000,21248,,,10051,659,31548,83,19,0,249,829.43,752.36,769.92,4.0
2020-11-01,972,22220,,,10036,957,32505,97,27,0,249,848.57,772.82,826.05,2.86
2020-11-02,900,23120,,,9968,834,33339,91,32,2,251,790.57,778.94,828.43,2.14
2020-11-03,875,23995,,,10135,1054,34393,94,32,12,263,821.86,806.45,896.1,3.57
2020-11-04,820,24815,,,10339,1032,35425,82,27,8,271,854.86,829.0,936.87,3.57
2020-11-05,839,25654,,,10503,1009,36434,78,28,6,277,906.29,847.0,958.51,4.43
2020-11-06,726,26380,,,11530,1755,38189,83,32,2,279,1042.86,937.8,1197.46,4.29
2020-11-07,1029,27409,,,11666,1168,39357,87,32,3,282,1115.57,960.82,1188.62,4.71
2020-11-08,825,28234,,,11689,852,40209,94,32,4,286,1100.57,949.94,1087.63,5.29
2020-11-09,1345,29579,,,11308,972,41181,86,31,8,294,1120.29,952.14,1052.94,6.14
2020-11-10,725,30304,,,11446,869,42050,82,27,6,300,1093.86,943.83,997.76,5.29
2020-11-11,769,31073,,,11497,822,42872,86,30,2,302,1063.86,931.65,945.03,4.43
2020-11-12,996,32069,,,11419,919,43791,92,35,1,303,1051.0,930.38,937.22,3.71
2020-11-13,900,32969,,,11822,1304,45095,96,39,1,304,986.57,967.74,1047.26,3.57
2020-11-14,803,33772,,,12131,1114,46209,103,43,2,306,978.86,982.37,1067.28,3.43
2020-11-15,1013,34785,,,12323,1208,47417,104,42,3,309,1029.71,1004.93,1109.5,3.29
2020-11-16,821,35606,,,12601,1103,48520,102,39,4,313,1048.43,1014.74,1107.55,2.71
2020-11-17,1018,36624,,,12788,1210,49730,105,40,5,318,1097.14,1034.27,1138.28,2.57
2020-11-18,630,37254,,,12814,660,50390,103,41,4,322,1074.0,996.84,994.8,2.86
2020-11-19,878,38132,,,13222,1290,51680,110,37,4,326,1127.0,1026.16,1083.36,3.29
2020-11-20,956,39088,,,13221,958,52638,110,42,3,329,1077.57,1019.34,1045.75,3.57
2020-11-21,1405,40493,,,12854,1041,53679,108,45,3,332,1067.14,1021.51,1044.33,3.71
2020-11-22,1104,41597,,,12843,1096,54775,106,46,3,335,1051.14,1028.96,1059.83,3.71
2020-11-23,883,42480,,,13842,1884,56659,115,48,2,337,1162.71,1114.46,1307.08,3.43
2020-11-24,1673,44153,,,14353,2188,58847,112,49,4,341,1302.43,1221.81,1571.36,3.29
2020-11-25,2348,46501,,,12971,970,59817,110,47,4,345,1346.71,1196.63,1390.95,3.29
2020-11-26,2555,49056,,,11348,935,60752,110,45,3,348,1296.0,1170.47,1254.16,3.14
2020-11-27,1148,50204,,,11307,1109,61861,113,41,2,350,1317.57,1164.32,1210.62,3.0
2020-11-28,1110,51314,,,11508,1315,63176,118,43,4,354,1356.71,1179.39,1241.93,3.14
2020-11-29,1333,52647,,,11481,1309,64485,116,42,3,357,1387.14,1192.35,1262.05,3.14
2020-11-30,2112,54759,,,10578,1212,65697,113,42,3,360,1291.14,1194.32,1247.04,3.29
2020-12-01,1552,56311,,,10495,1472,67169,120,44,3,363,1188.86,1222.08,1314.53,3.14
2020-12-02,658,56969,,,10686,851,68020,122,47,2,365,1171.86,1184.98,1175.47,2.86
2020-12-03,948,57917,,,10802,1075,69095,116,46,11,376,1191.86,1173.98,1145.33,4.0
2020-12-04,1144,59061,,,10799,1141,70236,129,53,0,376,1196.43,1170.68,1144.03,3.71
2020-12-05,1143,60204,,,10775,1123,71359,130,54,4,380,1169.0,1165.91,1137.72,3.71
2020-12-06,1069,61273,,,11039,1335,72694,126,57,2,382,1172.71,1182.82,1196.9,3.57
2020-12-07,1033,62306,,,11604,1600,74294,129,57,2,384,1228.14,1224.54,1317.83,3.43
2020-12-08,1750,64056,,,10862,1012,75306,126,62,4,388,1162.43,1203.29,1226.08,3.57
2020-12-09,1068,65124,,,10748,959,76265,127,61,5,393,1177.86,1178.86,1145.96,4.0
2020-12-10,1112,66236,,,11867,2234,78499,124,60,3,396,1343.43,1284.37,1472.37,2.86
2020-12-11,937,67173,,,12734,1810,80309,123,63,6,402,1439.0,1336.93,1573.66,3.71
2020-12-12,911,68084,,,13751,1937,82246,121,66,9,411,1555.29,1396.94,1682.66,4.43
2020-12-13,1309,69393,,,13667,1229,83475,115,65,4,415,1540.14,1380.15,1546.56,4.71
2020-12-14,1204,70597,,,13830,1371,84846,114,62,4,419,1507.43,1379.23,1493.89,5.0
2020-12-15,1084,71681,,,14515,1772,86618,118,56,3,422,1616.0,1418.51,1577.33,4.86
2020-12-16,1052,72733,,,14751,1295,87913,113,53,7,429,1664.0,1406.16,1492.63,5.14
2020-12-17,1297,74030,,,14671,1220,89133,106,53,3,432,1519.14,1387.54,1410.84,5.14
2020-12-18,1214,75244,,,15140,1683,90816,106,51,0,432,1501.0,1417.09,1492.49,4.29
2020-12-19,998,76242,,,15294,1153,91969,112,56,1,433,1389.0,1390.68,1390.64,3.14
2020-12-20,1067,77309,,,15563,1340,93309,116,57,4,437,1404.86,1385.61,1375.45,3.14
2020-12-21,1084,78393,,,16496,2018,95327,109,55,1,438,1497.29,1448.85,1568.21,2.71
2020-12-22,911,79304,,,17646,2062,97389,111,51,1,439,1538.71,1510.16,1716.35,2.43
2020-12-23,710,80014,,,18279,1348,98737,102,44,5,444,1546.29,1493.95,1605.85,2.14
2020-12-24,1085,81099,,,18773,1581,100318,102,45,2,446,1597.86,1502.65,1598.39,2.0
2020-12-25,1441,82540,,,18576,1247,101565,108,47,3,449,1535.57,1477.09,1492.97,2.43
2020-12-26,874,83414,,,20035,2335,103900,108,50,2,451,1704.43,1562.88,1745.58,2.57
2020-12-27,997,84411,,,20233,1196,105096,111,50,1,452,1683.86,1526.19,1580.71,2.14
2020-12-28,1181,85592,,,20643,1594,106690,116,53,3,455,1623.29,1532.97,1584.7,2.43
2020-12-29,1123,86715,,,21443,1925,108615,117,55,2,457,1603.71,1572.18,1686.79,2.57
2020-12-30,745,87460,,,22562,1870,110485,131,62,6,463,1678.29,1601.96,1741.75,2.71
2020-12-31,1481,88941,,,23598,2525,113010,131,60,8,471,1813.14,1694.26,1976.73,3.57
2021-01-01,2230,91171,,,23433,2068,115078,126,54,3,474,1930.43,1731.64,2004.11,3.57
2021-01-02,3321,94492,,,22398,2295,117373,125,51,9,483,1924.71,1787.97,2091.38,4.57
2021-01-03,2726,97218,,,21365,1704,119077,124,51,11,494,1997.29,1779.57,1975.16,6.0
2021-01-04,1010,98228,,,22089,1741,120818,122,53,7,501,2018.29,1775.72,1904.91,6.57
2021-01-05,1221,99449,,,22887,2027,122845,123,52,8,509,2032.86,1800.85,1941.54,7.43
2021-01-06,1129,100578,,,24347,2593,125438,141,67,4,513,2136.14,1880.06,2136.98,7.14
2021-01-07,2145,102723,,,25221,3027,128465,142,63,8,521,2207.86,1994.75,2403.98,7.14
2021-01-08,2708,105431,,,25140,2643,131108,170,82,16,537,2290.0,2059.58,2475.69,9.0
2021-01-09,1401,106832,,,26185,2451,133559,177,82,5,542,2312.29,2098.72,2468.28,8.43
2021-01-10,1277,108109,,,27332,2433,135992,171,76,9,551,2416.43,2132.15,2457.7,8.14
2021-01-11,1006,109115,,,28554,2232,138224,187,87,4,555,2486.57,2142.13,2389.99,7.71
2021-01-12,1469,110584,,,30390,3309,141533,190,83,4,559,2669.71,2258.82,2665.69,7.14
2021-01-13,994,111578,,,32377,2985,144518,197,79,4,563,2725.71,2331.44,2761.48,7.14
2021-01-14,1710,113288,,,33989,3337,147855,195,86,15,578,2770.0,2432.0,2934.14,8.14
2021-01-15,1939,115227,,,35253,3211,151066,204,87,8,586,2851.14,2509.9,3017.2,7.0
2021-01-16,2148,117375,,,37126,4029,155095,205,79,8,594,3076.57,2661.81,3320.74,7.43
2021-01-17,2676,120051,,,37782,3339,158434,240,93,7,601,3206.0,2729.53,3326.22,7.14
2021-01-18,2293,122344,,,38791,3306,161740,226,94,4,605,3359.43,2787.17,3320.15,7.14
2021-01-19,2944,125288,,,39464,3631,165371,238,96,14,619,3405.43,2871.56,3413.41,8.57
2021-01-20,2374,127662,5.0,4003.0,41087,4008,169379,246,96,11,630,3551.57,2985.2,3591.78,9.57
2021-01-21,2490,130152,8.0,3162.0,41755,3170,172549,260,103,12,642,3527.71,3003.68,3465.25,9.14
2021-01-22,2554,132706,6.0,3625.0,42814,3631,176180,251,102,18,660,3587.71,3066.41,3514.97,10.57
2021-01-23,4313,137019,11.0,4264.0,42769,4275,180455,260,103,7,667,3622.86,3187.27,3742.98,10.43
2021-01-24,4427,141446,7.0,3339.0,41677,3346,183801,265,102,11,678,3623.86,3203.14,3623.89,11.0
2021-01-25,3638,145084,8.0,3040.0,41076,3048,186849,261,101,11,689,3587.0,3187.63,3451.12,12.0
2021-01-26,4076,149160,2.0,3583.0,40574,3585,190434,280,111,11,700,3580.43,3227.37,3491.28,11.57
2021-01-27,1858,151018,6.0,3674.0,42389,3680,194114,314,122,7,707,3533.57,3272.63,3547.9,11.0
2021-01-28,3281,154299,8.0,4086.0,43192,4094,198208,303,118,10,717,3665.57,3354.77,3711.73,10.71
2021-01-29,3423,157722,7.0,5718.0,45478,5725,203933,301,115,16,733,3964.71,3591.79,4315.71,10.43
2021-01-30,3805,161527,5.0,5723.0,47388,5728,209661,319,120,13,746,4172.29,3805.41,4739.4,11.29
2021-01-31,4522,166049,3.0,5295.0,48150,5298,214959,313,127,14,760,4451.14,3954.67,4906.98,11.71
2021-02-01,4280,170329,9.0,4205.0,48074,4214,219173,316,137,10,770,4617.71,3980.6,4699.08,11.57
2021-02-02,3661,173990,5.0,3450.0,47847,3455,222628,327,145,21,791,4599.14,3928.04,4325.86,13.0
2021-02-03,3804,177794,6.0,4278.0,48309,4284,226912,307,141,18,809,4685.43,3963.64,4313.3,14.57
2021-02-04,4092,181886,3.0,4568.0,48771,4571,231483,308,135,17,826,4753.57,4024.37,4390.61,15.57
2021-02-05,3392,185278,4.0,3387.0,48751,3391,234874,310,134,19,845,4420.14,3961.04,4090.73,16.0
2021-02-06,1692,186970,4.0,3843.0,50894,3847,238721,305,139,12,857,4151.43,3949.63,4017.61,15.86
2021-02-07,3369,190339,8.0,3723.0,51241,3731,242452,292,140,15,872,3927.57,3927.77,3931.63,16.0
2021-02-08,2340,192679,1.0,3099.0,51977,3100,245552,282,134,24,896,3768.43,3844.99,3682.14,18.0
2021-02-09,3887,196566,6.0,2758.0,50841,2764,248316,289,127,13,909,3669.71,3736.89,3406.7,16.86
2021-02-10,1929,198495,5.0,3283.0,52186,3288,251604,285,131,14,923,3527.43,3692.0,3371.09,16.29
2021-02-11,3774,202269,15.0,3369.0,51783,3384,254988,259,122,13,936,3357.86,3661.2,3374.96,15.71
2021-02-12,3505,205774,7.0,3311.0,51579,3318,258306,258,119,17,953,3347.43,3626.88,3357.87,15.43
2021-02-13,3515,209289,1.0,3498.0,51558,3499,261805,263,118,5,958,3297.71,3614.1,3400.21,14.43
2021-02-14,4525,213814,3.0,2461.0,49490,2464,264269,260,111,7,965,3116.71,3499.09,3119.35,13.29
2021-02-15,4521,218335,1.0,2175.0,47135,2176,266445,260,112,10,975,2984.71,3366.78,2836.34,11.29
2021-02-16,5718,224053,0.0,2720.0,44129,2720,269165,253,118,8,983,2978.43,3302.1,2801.44,10.57
2021-02-17,5709,229762,7.0,2991.0,41396,2998,272163,231,115,22,1005,2937.0,3271.69,2860.41,11.71
2021-02-18,5320,235082,4.0,2708.0,38763,2712,274875,227,103,25,1030,2841.0,3215.72,2815.89,13.43
2021-02-19,4889,239971,17.0,2919.0,36797,2936,277811,220,104,13,1043,2786.43,3187.75,2851.92,12.86
2021-02-20,4782,244753,0.0,2461.0,34468,2461,280272,207,91,8,1051,2638.14,3115.07,2734.64,13.29
2021-02-21,4456,249209,6.0,3291.0,33304,3297,283569,209,91,5,1056,2757.14,3133.27,2903.35,13.0
2021-02-22,3414,252623,3.0,2189.0,32076,2192,285761,199,91,6,1062,2759.43,3039.14,2689.95,12.43
2021-02-23,4055,256678,4.0,2464.0,30475,2468,288229,196,92,14,1076,2723.43,2982.03,2623.36,13.29
2021-02-24,3331,260009,1.0,3544.0,30677,3545,291774,189,88,12,1088,2801.57,3038.32,2899.85,11.86
2021-02-25,3752,263761,6.0,1918.0,28837,1924,293698,205,91,12,1100,2689.0,2926.89,2607.1,10.0
2021-02-26,3085,266846,7.0,2246.0,27994,2253,295951,201,93,11,1111,2591.43,2859.5,2500.87,9.71
2021-02-27,3320,270166,1.0,2363.0,27028,2364,298315,190,99,10,1121,2577.57,2809.95,2459.81,10.0
2021-02-28,3251,273417,2.0,2435.0,26205,2437,300752,202,93,9,1130,2454.71,2772.66,2452.97,10.57
2021-03-01,2486,275903,7.0,1821.0,25542,1828,302580,198,90,5,1135,2402.71,2678.19,2265.48,10.43
2021-03-02,2528,278431,3.0,1552.0,24563,1555,304135,204,96,6,1141,2272.29,2565.87,2052.33,9.29
2021-03-03,2276,280707,2.0,1743.0,24025,1745,305880,195,95,7,1148,2015.14,2483.78,1960.13,8.57
2021-03-04,2922,283629,9.0,2054.0,23161,2063,307943,193,99,5,1153,2035.0,2441.71,1990.99,7.57
2021-03-05,3275,286904,5.0,2149.0,22034,2154,310097,184,87,6,1159,2020.86,2412.94,2039.9,6.86
2021-03-06,2548,289452,3.0,1677.0,21159,1680,311777,172,84,7,1166,1923.14,2339.64,1931.93,6.43
2021-03-07,2506,291958,10.0,1673.0,20333,1683,313460,174,81,3,1169,1815.43,2273.98,1857.25,5.57
2021-03-08,2076,294034,9.0,1520.0,19778,1529,314989,160,79,8,1177,1772.71,2199.48,1758.77,6.0
2021-03-09,2345,296379,2.0,1278.0,18704,1280,316269,155,76,9,1186,1733.43,2107.53,1615.14,6.43
2021-03-10,2137,298516,10.0,1438.0,18010,1448,317717,151,72,5,1191,1691.0,2041.58,1565.0,6.14
2021-03-11,2104,300620,5.0,1642.0,17544,1647,319364,147,61,9,1200,1631.57,2002.12,1589.6,6.71
2021-03-12,2042,302662,7.0,1568.0,17074,1575,320939,147,67,3,1203,1548.86,1959.41,1585.22,6.29
2021-03-13,1830,304492,12.0,1458.0,16711,1470,322409,162,70,3,1206,1518.86,1910.47,1550.65,5.71
2021-03-14,1782,306274,14.0,1340.0,16279,1354,323763,158,71,4,1210,1471.86,1854.82,1491.66,5.86
2021-03-15,1973,308247,9.0,1199.0,15511,1208,324971,155,70,3,1213,1426.0,1790.14,1406.56,5.14
2021-03-16,1365,309612,4.0,1059.0,15204,1063,326034,152,68,5,1218,1395.0,1717.43,1303.49,4.57
2021-03-17,1346,310958,7.0,1212.0,15075,1219,327253,154,64,2,1220,1362.29,1667.58,1278.14,4.14
2021-03-18,1503,312461,6.0,1207.0,14782,1213,328466,155,54,3,1223,1300.29,1622.12,1258.6,3.29
2021-03-19,1996,314457,11.0,1565.0,14360,1576,330042,151,57,2,1225,1300.43,1617.51,1353.82,3.14
2021-03-20,1585,316042,2.0,1669.0,14442,1671,331713,151,64,4,1229,1329.14,1622.86,1448.97,3.29
2021-03-21,1247,317289,11.0,1316.0,14518,1327,333040,154,65,4,1233,1325.29,1593.27,1412.38,3.29
2021-03-22,1495,318784,8.0,1108.0,14134,1116,334156,156,60,5,1238,1312.14,1545.55,1323.47,3.57
2021-03-23,1058,319842,9.0,1375.0,14454,1384,335540,148,62,6,1244,1358.0,1529.39,1341.63,3.71
2021-03-24,1083,320925,5.0,1263.0,14637,1268,336808,161,73,2,1246,1365.0,1503.25,1319.54,3.71
2021-03-25,1491,322416,1.0,1359.0,14504,1360,338168,157,72,2,1248,1386.0,1488.93,1331.68,3.57
2021-03-26,1509,323925,32.0,1243.0,14269,1275,339443,161,70,1,1249,1343.0,1467.54,1314.67,3.43
2021-03-27,1257,325182,5.0,1194.0,14209,1199,340642,167,72,2,1251,1275.57,1440.68,1279.97,3.14
2021-03-28,1127,326309,9.0,1293.0,14380,1302,341944,169,76,4,1255,1272.0,1426.81,1286.58,3.14
2021-03-29,1097,327406,8.0,933.0,14219,941,342885,166,73,5,1260,1247.0,1378.23,1182.91,3.14
2021-03-30,1148,328554,8.0,1125.0,14199,1133,344018,161,76,5,1265,1211.14,1353.71,1167.93,3.0
2021-03-31,1070,329624,2.0,1480.0,14604,1482,345500,164,81,7,1272,1241.71,1366.54,1262.15,3.71
2021-04-01,1377,331001,20.0,1158.0,14399,1178,346678,163,81,6,1278,1215.71,1347.68,1236.91,4.29
2021-04-02,1442,332443,26.0,1268.0,14246,1294,347972,168,78,5,1283,1218.43,1342.32,1254.04,4.86
2021-04-03,1449,333892,7.0,1631.0,14432,1638,349610,167,81,3,1286,1281.14,1371.88,1369.22,5.0
2021-04-04,1270,335162,7.0,1342.0,14509,1349,350959,186,94,2,1288,1287.86,1369.6,1363.16,4.71
2021-04-05,1294,336456,9.0,1061.0,14278,1070,352029,180,89,7,1295,1306.29,1339.64,1275.21,5.0
2021-04-06,1412,337868,24.0,1276.0,14161,1300,353329,189,88,5,1300,1330.14,1335.67,1282.65,5.0
2021-04-07,1199,339067,13.0,1126.0,14097,1139,354468,194,86,4,1304,1281.14,1316.01,1239.55,4.57
2021-04-08,1175,340242,17.0,1268.0,14203,1285,355753,186,81,4,1308,1296.43,1312.9,1253.19,4.29
2021-04-09,1247,341489,20.0,1834.0,14805,1854,357607,169,79,5,1313,1376.43,1367.01,1433.43,4.29
2021-04-10,1248,342737,5.0,1505.0,15059,1510,359117,194,81,8,1321,1358.14,1381.31,1456.4,5.0
2021-04-11,1216,343953,8.0,1731.0,15574,1739,360856,183,81,8,1329,1413.86,1417.08,1541.18,5.86
2021-04-12,1052,345005,12.0,1305.0,15835,1317,362173,188,84,4,1333,1449.14,1407.07,1473.93,5.43
2021-04-13,1290,346295,9.0,1758.0,16300,1767,363940,199,82,12,1345,1515.86,1443.07,1561.85,6.43
2021-04-14,1485,347780,6.0,1883.0,16696,1889,365829,204,79,8,1353,1623.0,1487.66,1659.99,7.0
2021-04-15,1259,349039,19.0,2129.0,17575,2148,367977,212,82,10,1363,1746.29,1553.69,1806.4,7.86
